111111111111111111111111111111111111111111111111111111111111111111111111111111
100C0C0C0C0C0C0C0C0C0C0C0C0C0C0C0C0C0C0C0C0C0C0C0C0C0C0C0C0C0C0C0C0C0C0C0C0C01
100011111111111111111001111111111111111111001111111111111111111111111111111001
1000100C0C0C0C0C000000C000000C0C0C000000010C0000000000000C0C0C0000000000000011
100010000111111111111111111110000001111111010111110000011100111111111111111101
100010000100000000000000000010000000000C00001000001000101000000001000000000001
1000100010111111111000000001011111111111111100000111010111111000000000C0C00011
10001000010000000001000000C0C0000000000000000000000000100000000000000000000001
10C000000011111111111111100000000000000000000000000000011111111100011111111111
111111111111111111111100000000000001111111100000011111100111111100000000000001
100000000000000000000000000000000000000000000001000010000000000000000000000001
100000001111111111111111100000001111111111111000011111100000C00C00C0C0C0C0C011
1000C000000000000000C0C0C0000C000000000000000000000000000000000000000000000001
100011111111111111111111111111111111111111111111111111110111111111111111111101
1000C0C0C0C000000000C000000000000C000C0000000000C0C000C0C00000000P0E00C0000001
111111111111111111111111111111111111111111111111111111111111111111111111111111