11111111111111111111111111
10P01000101C01111111111111
10CC0C00001101111111111111
11011101C00001111111111111
11111111111101111111111111
11111111111101111111111111
11111111111101111111111111
11111111111101111111111111
11111111111101111111111111
11111111111101111111111111
1111111111110111110G011111
11111111111101111111111111
11111111111101111111111111
11111111111101111111111111
11111111111101111111111111
11111111111101111111111111
11111111111101111111111111
11111111111101111111111111
100000000000000000000000E1
11111111111111111111111111