11111111111111111111111111
1CCCCCCCCCCCCCCCCCCCCCPC11
10000000000000000000000011
10000000000000000000000011
10000000000000000000000011
10000000000000000000000011
10000000000000000000000011
10000000000000000000000011
10000000000000000000000011
10000000000000000000000011
10000000000000000000000011
10000000000000000000000011
10000000000000000000000011
10000000000000000000000011
10000000000000000000000011
10000000000000000000000011
10000000000000000000000011
10000000000000000000000011
10000000000000E00000000011
11111111111111111111111111