111111111111111111111111111111111111111111111111111111
1P000000000C00000000000C00100000000C000000000000000001
100011111110011111100011010011111100000111111111100001
100010000000010000000011101010000000000010000000000011
100010001111110011111100000101111111101111110000000001
100010001000010010000001000011010000010010001111111101
100010001011010011111100000101000010001001000000000001
100010000000010000000011101010001110001001000000000011
10C000000011110011111100011010000011000000011111100011
111111111011110011111100000010001100011111100111100001
100000000011000010000000000010000010000000000000000001
100000001100010000100000001000001100000000000000000001
100011111100011111000011110101111000111100111111110001
1000000000000000000000000000000000000000000000000000E1
111111111111111111111111111111111111111111111111111111