111111111111111111111111111111111111111111111111111111111111111111111
1P00000000000000000000C000000000000000C001000000000000000000000000001
100011111111111111111001111111000000001101000111111100000111111111111
100010000000000000000000000000000000000001010000000000010000000000011
100010000111111111111111111110000001111111010111110000011100111111101
100010000100000000000000000010000000000000010000010001010000000000001
100010000101111111110000000010111111111111110000011101011111100000011
100010000100000000010000000010000000000000000000000000010000000000001
10C000000011111111111111100000000000000000000000000000011111111100011
111111111111111111111100000000000001111111100000011111100111111100001
100000000000000000000000000000000000000000000001000010000000000000001
100000001111111111111111100000001111111111111000011111100000000000011
100000000000000000000000000000000000000000000000000000000000000000001
100011111111111111111111111111111111111111111111111111110111111111101
1000000000000000000000000000000000000000000000000000000000000000000E1
111111111111111111111111111111111111111111111111111111111111111111111