111111111111111111111111111111111111111111111111111111111111111111111
1P000C0000C0C00000000C0C000000C00C0C0C0C00C0C0C0C0000C0C00C0000C0C001
100011111111111111111001111111000000001101000111111100000111111111111
1000100000000000000000C000000C0000000000010C000000000010000000C000011
100010000111111111111111111110000001111111010111110000011100111111101
100010000100000000000000000010000000000C00001000001000101000000000001
100010000101111111110000000010111111111111110000011101011111100000011
1000100001000000000100000000C000000000000000000000000010C000000000001
10C000000011111111111111100000000000000000000000000000011111111100011
111111111111111111111100000000000001111111100000011111100111111100001
100000000000000000000000000000000000000000000001000010000000000000001
100000001111111111111111100000001111111111111000011111100000000000011
1000000000000000000000C0000000000000000000000000000000000000000000001
100011111111111111111111111111111111111111111111111111110111111111101
100000000000000000000000000000000C000C00000000000000000000000000000E1
111111111111111111111111111111111111111111111111111111111111111111111